{
    "map_1":[
        [ 7,  0,  0,  0,  0,  0,  0,  0,  0,  0,  0,  0,  0,  0,  0,  0,  0,  0,  0,  0,  0,  0,  0,  0,  0,  0,  8],
        [ 7,  0,  0,  0,  0,  0,  0,  0,  0,  0,  0,  0,  0,  0,  0,  0,  0,  0,  0,  0,  0,  0,  0,  0,  0,  0,  8],
        [ 7,  0,  0,  0,  0,  0,  0,  0,  0,  0,  0,  0,  0,  0,  0,  0,  0,  0,  0,  0,  0,  0,  0,  0,  0,  0,  8],
        [ 7,  0,  0,  0,  0,  0,  0,  0,  0,  0,  0,  0,  0,  0,  0,  0,  0,  0,  0,  0,  0,  0,  0,  0,  0,  0,  8],
        [ 7,  0,  0,  0,  0,  0,  0,  0,  0,  0,  0,  0,  0,  0,  0,  0,  0,  0,  0,  0,  0,  0,  0,  0,  0,  0,  8],
        [ 7,  0,  0,  0,  0,  0,  0,  0,  0,  0,  0,  0,  0,  0,  2,  3,  4,  5,  6,  0,  0,  0,  0,  0,  0,  0,  8],
        [ 7,  0,  0,  0,  0,  0,  0,  0,  0,  0,  0,  1,  0,  0,  0,  0,  0,  0,  0,  0,  0,  0,  0,  0,  0,  0,  8],
        [ 7,  0,  0,  0,  0,  2,  3,  4,  5,  6,  0,  0,  0,  0,  0,  0,  0,  0,  0,  0,  0,  0,  0,  0,  0,  0,  8],
        [ 7,  0,  0,  0,  0,  0,  0,  0,  0,  0,  0,  0,  0,  0,  0,  0,  0,  0,  0,  0,  0,  0,  0,  0,  0,  0,  8],
        [ 7,  0,  0,  0,  0,  0,  0,  0,  0,  0,  0,  0,  0,  0,  0,  0,  0,  0,  0,  0,  0,  0,  0,  0,  0,  0,  8],
        [19,  9, 10, 11, 12, 10, 11, 12, 10, 11, 12, 10, 11, 12, 10, 11, 12, 10, 11, 12, 10, 11, 12, 10, 11, 12, 20],
        [18, 14, 15, 16, 17, 15, 16, 17, 15, 16, 17, 15, 16, 17, 15, 16, 17, 15, 16, 17, 15, 16, 17, 15, 16, 17, 14]
    ],
    "items_1":[
      [-1, -1, -1, -1, -1, -1, -1, -1, -1, -1, -1, -1, -1, -1, -1, -1],
      [-1, -1, -1, -1, -1, -1, -1, -1, -1, -1, -1, -1, -1, -1, -1, -1],
      [-1, -1, -1, -1, -1, -1, -1, -1, -1, -1, -1, -1, -1, -1, -1, -1],
      [-1, -1, -1, -1, -1, -1, -1, -1, -1, -1, -1, -1, -1, -1, -1, -1],
      [-1, -1, 33, -1, -1, -1, -1, -1, -1, -1, -1, -1, -1, 33, -1, -1],
      [-1,  7, -1, -1, -1, -1, -1, 14, -1, -1, -1, -1, -1, -1,  7, -1],
      [-1,  7, -1, -1, -1, -1, -1, -1, -1, -1, -1, -1, -1, -1,  7, -1],
      [-1, -1, -1, -1, -1, -1, -1, -1, -1, -1, -1, -1, -1, -1, -1, -1],
      [-1, -1, 33, -1, -1, -1, -1, -1, -1, -1, -1, -1, -1, 33, -1, -1],
      [-1, -1, -1, -1, -1,  8, -1, -1, -1, -1, 31, -1, -1, -1, -1, -1],
      [-1, -1, -1, -1, -1, -1, -1, -1, -1, -1, -1, -1, -1, -1, -1, -1],
      [-1, -1, -1, -1, -1, -1, -1, -1, -1, -1, -1, -1, -1, -1, -1, -1] 
    ]
}